111111111111111111111111111111
100000000000000000000000000001
100000000000000000000000000001
100000000000000000000000000001
100000000000000000000000000001
100000000000000000000000000001
100000000000000000000000000001
100000000000000000000000000001
100000000000000000000000000001
100000000011111000000000000001
100000000000P00000000000000001
100000000000P00000000000000001
100000000000P00000000000000001
100000000000P00000000000000001
100000000000P00000000000000001
100000000000P00000000000000001
100000000000100000000000000001
103333330033333003333000033331
103000000000000000000000000001
111111111111111111111111111111
