111111100001111111111111111111
100000000000000000000000000001
100000000111000000000000000001
100000000111000000000000000000
100000000000000000000000000000
100000111000000000000000000000
100000111000000000111111111111
111000000000000000000000000001
111000000000000000000000000001
111110000000000000000000000001
100000000000000011000000000001
100000000000000000000000000001
100000011110000000000000000001
100000000000000000011110000001
100000000000000000000010000001
100000000000000000000011110001
100000000000000000000000000001
Z00000000110000000000000000000
Z0000000A110000000000000A00000
111111111110001111111111111111
