111111111111111111111111111111
100000000000000000000000000001
100000000000000000000000000001
Z00000000000000000000000000000
Z00000000000000000000000000000
Z00000000000000000000000000000
111100000000000000000000001111
111111000000000000000000111111
111111000000000000000000111111
111111110000000000000011111111
111111110000000000000011111111
111111111100000000001111111111
111100000000000000000000001111
111000000000001100000000000011
100000000000000000000000000001
100000001110000000011100000001
100000000000000000000000000001
000000000000111111000000000000
000000000000111111000000000000
111111111111111111111111111111
