111111111110001111111111111111
100000001110000000000000000001
100000001110000000000000000001
100000000111000000000000000001
100000000011100000000000000001
100000000011111000000000000001
100000000000111100000000000001
100000000000011111000000000001
100000000000000011000000000011
100000000000000011110000000000
100000000000000000000000000000
100000000001111111111111111111
100000000001100000000000000001
100000011111100000000000000001
111000001111100000000000000000
111000000111100000000000000000
111000000011111111000000000111
111110000000000000000000011111
111110000000000000000011111111
111111111111111111111111111111
