118111111001411111114181111111
111111141001118811411111111181
141811111001141111114111111111
110000000000000000000000000011
110000000000000000000000000011
810000000000000000000000000081
110000000000000000000000000011
110000000000000000000000000011
180000000000000000000000000011
110000000000000000000000000014
110000000000000000000000000011
810000000000000000000000000000
110000000000000000000000000000
140000000000000000000000000000
000000000000000000000000111111
000000000000000000000000000181
000000000000000000000000000411
111411181111811114111111111111
411181118111111111118111811111
141111111441118141111111114181
