141118111111111811111411111811
111111141111111111111111111111
111111111111111111111111411111
111111111141111111111111111141
181111181111111141111111111111
111113333333333333333118111118
111143000000000000003111111111
111813000000000000003111111411
111113000000000000003811111111
111113000000000000003111111111
181113000000000000003114111111
ZZZZZZ000000000000003111111118
111113000000000000003111111111
411813000000000000003111111411
111113333003333333333811111111
111111111001111111118111111111
811141111008111411111118111114
111111181001111111111111411111
111111111001141111111111111111
111141111001111111181111111111
