111111111111111111111111111111
000000000000000000000111111111
000000000000000000000000000000
000000000000000000000000000000
111100000111111111111111111111
000010001000000000000000000001
000001010000000000000000000001
000000100000000000000000000001
000000000000000000000000000001
111111111100000000000000000001
100000000010000000000000000001
100000000001000000000000000001
100000000000010000000000000001
100000000000001000000000000001
100000000000000100000000000001
000000000000000010000000000000
000000000000000001000000000000
000000000000000000100000000000
111111111111111111111111111111
111111111111111111111111111111
