118111111001411111111181111111
111111141001111811411111111181
111811111001111111114111111111
110000000000000000000000000011
110000000000000000000000000011
810000000000000000000000000081
110000000000000000000000000011
110000000000000000000000000011
180000000000000000000000000011
110000000000000000000000000014
110000000000000000000000000011
110000000000000000000000000000
110000000000000000000000000000
110000000000000000000000000000
000000000000000000000000111111
000000000000000000000000000181
000000000000000000000000000411
111411111111811114111111111111
111181111111111111118111111111
141111111141118111111111114181
