111111111111111111111111111111
000000000000000000000000000000
111111111111111111111111111111
110000000000000000000000000011
110000000000000000000000000011
110000000000000000000000000011
110000000000000000000000000011
110000000000000000000000000011
110000033330033333000333000011
110000033330033333000333000011
110000000000000000000000000011
110000000000000000000000000011
110003333000333003330003330011
110003333000333003330003330011
110003333000333003330003330011
000000000000000000000000000000
000000000000000000000000000000
333333333333333333333333333333
333333333333333333333333333333
111111111111111111111111111111
