141118111111111811111411111811
111111141111411111111111111111
111111111111111111141111411111
111411111144111111111111111141
181111181111181141111111111111
111113333333333333333118111118
111143000000000000003111111111
141113000000000000003111111411
111113000000000000003811111411
111183000000000000003111411111
181113000000000000003114111111
ZZZZZZ000000000000003111111118
111113000000000000003141111111
411813000000000000003111114411
111113333003333333333811114111
111111111001111111818111111111
811441111008111411111118111114
111111181001111141111111411111
818111111001141111114111111811
111141111001111111181111811111
