111111111111111111111111111111
100000000000000000000000000001
100000000000000000000000000001
Z00000000000000000000000000000
Z00000000000000000000000000000
Z00000000000000000000000000000
111400000000000000000000001851
111511000000000000000000111111
511111000000000000000000115115
118111510000000000000041511111
111151110000000000000011115154
151141118100000000008115111811
141100000000000000000000001115
111000000000055550000000000041
500000000000000000000000000001
100000005550000000055500000001
100000000000000000000000000001
000000000000555555000000000000
000000000000115115000000000000
111111111111111111111111111111
