111811111111110000111111111111
115111114111510000000111111111
411118111551110000000111111111
111511111111111170000111111111
181111111114151117000111111111
111111515111111111700000000000
111115111114115181170000000000
151111115111111111511111151111
111141111111118111111111111114
114185111815111111114118115111
111111411111111151111111111111
411111111111141111111515111815
115111111151111118111111111111
118111514111111111141111151111
111111511111551141111181111181
111151111811111151151111511111
111811115111141111111151111141
151111111111111111111111115111
114118151151815114555118118111
115111114111111111411111111115
