111000000000000000000000000114
000000000000000000000000000811
111111111111111111111111111111
110000000000000000000000001114
110000000000000000000000008111
110000000000000000000000001181
110000000000000000000000001111
110000000033333300001111114118
110000000033333333000000001118
110000330000333333000000001811
110000000000333333300000001111
111100000000000033300000001141
111100000000000000000000008111
111100000000000000000000001181
111111001000000000000000000000
000000001000000000000000000000
000000001000000000000000000000
515115151000000000055151570000
151151151150000051111111111111
111111111111100111111111111111
