111111111111111111111111110001
111111111111111110000000000001
111111111111111110000000000001
00000000000000G000000000000111
000000000000000000000000000111
000000000000000000000000111111
111113311111111111111133111111
133333333333333333333333333311
133333333333333333333333333311
133333333333333333333333333311
133333333333333333333333333311
111113311111111111111333333311
100000000000000001111133111111
100000000000000000000000000011
1000000000000000000000000000ZZ
100000000000000000000000000015
000000000000000000000000000051
000000000000000000000000000011
000000000000000000000000000011
115115111511510000115115111511
