111111111811111111181141111111
411111111111111141111111111111
118111141111111811111811118111
111000000000000000000000000111
111000000000000000000000000111
841000000000000000000000000141
111000000000000000000000000111
111000000000000000000000000111
111000000000000000000000000111
181000000000000000000000000411
111000010000000000000010000181
000000010000000000000010000000
000000011133333333331110000000
000000000000000000000000000000
111111111133333333331111111181
411411000000000000000000114111
111114000000000000000000411111
111000000000000000000000000111
141000000000000000000000000111
111000000000000000000000000811
