111111111111100111111111111111
111111111110000001111111111111
110000000000000000000000000011
110000000000011000000000000011
110000000000000000000000000011
110000000000000000000000000011
110000000000000000000000000011
110000000000011111000000000011
110000000000000000000011111111
110000000000000000000000000000
111111110000000000000000000000
110000000000000000000000000000
110000000000000000011111111111
110000000000000000000000000011
111111111111100000000000000011
110000000000000000000000000011
110000000000000000000000000000
110000000000000000000000000000
111111111111111111111111111111
111111111111111111111111111111
