110000000000000000000000000011
110000000000000000000000000011
110000000000000000000000000011
110000000000000000000003300000
113333333000000000000000000000
000000000000000000000000000000
000000000000000000003300000311
170000000000003333000000033311
117000000000000000000000000011
111700000000000000000000000011
111170000000000000033330000011
111111100000000000000000000011
110000000000000000000000000011
110000000000000000000000033311
110000000000000000000000000011
110000000000000000000000000011
110000000000000000003330000011
110000000000033330000000000011
110000000000000000000000000011
110000333330000000000000011111
