111111111111111111111111111111
111111111111111111111111111111
110000000011000011000000000011
110000000011000011000000000011
110000000011000011000000000011
110010000000000000000000000011
110000000111100111100000001011
110000000003100103100110000011
111111111100111100111110000011
000000000000111100000000100011
000000000000111100000000000011
00000000000000000H000000000011
111110000111111111100000001111
111110000000000000000000000011
111100000000000000000000000011
111100000000111100000001100011
000000000000111100011000000011
000000000000000000000000000011
111111111111111111111111111111
111111111111111111111111111111
