110000000000000000000000000011
110000000000000000000000000011
110000000000000000000000000011
110033300000000000033330000011
110000000000000000000000000011
110000000000333330000000000011
110000000000000000000000000011
110000333000000000000000000011
110000000000000000000000000011
110000000000333300000000000011
110000000000000000000000000011
000000000000000000000333000000
000003333300000000000000000000
000000000000000000000000000000
111000000000333333300000000111
110000000000000000000000000011
110000333300000000000333300011
110000000000000000000000000011
110000000000000000000000000011
110000000000000033333000000011
