110000000000000000000000000011
110000000000000000000000000011
110000000000000000000000000011
110000000000000000000000000011
11000000000000A000000000000011
110000000000003000000000000011
110000000000033300000000000011
110000000000000000000000000011
110000000000000000000000000011
110000000000000000000000000011
110000033330000000333300000011
110000000000000000000000000011
110000000000000000000000000011
110000000000033300000000000011
000000000000000000000000000011
110000000000000000000000000011
110000033330000000333333000011
110000000000000000000000000011
110000000000000000000000000011
110000000000000000000000003311
