110000000000000000000000000011
110000000000000000000000000011
110000000000000000000000000011
110000000033330000000000000011
110000000000000000000000000011
110033330000000000000033300011
110000000000000333300000000011
110000000000000000000000000011
110000000033300000000000000011
110000000000000003333000000011
110033330000000000000003330011
110000000000000000000000000011
110000000033300000000000000011
110000000000000000033333000011
000000000000000000000000000011
0000000000000000000000000000ZZ
000065555555555550000000000011
000611511511151150000000000011
555111111115111115555555555511
111111111111111111111111111111
