111111111111111111111111111111
100P0000000000P00000P000000001
100P0000000000P00000P000000001
100P0000000000P00000P000000001
100P0000010000P00000P000000001
100P0000010000P00000P000000001
100P0000010000P00000P000000001
100P0000010000P00000P000000001
100P0000010000100000P000000001
100P1111111000000000P000000001
100P0000G01000000000P000000001
100P0K00001000000000P000000001
100P1300001000000000P000000001
100P1111101000000000P001111101
100P0000101000000000P0000P0001
100P0000101000000000P0000P0001
10010000101000000000P0000P0001
1000000010100000000111100P0001
1000000010100000000000000P0001
1111111110100000000000000P0001
