111111111111111111100000010P01
100111111110001000100000010P01
100000000000001000000000010P01
100000000000001000000000010P01
100000000000000000000000010P01
100000000000000000003333010P01
100000000000000000030000010P01
100000000000003000030333310P01
100003330000003333330000010P01
100003330000003300033333010P01
100003030000003300000000010P01
000333033333333000033333310P01
000333000333003000300000010P01
000300000000003303000000010P01
133300061131103303003300010P01
100000610001100003003300010P01
100006100001100003003300010P01
100061000000131113033300010P01
10331000000000000003330S010P01
101110000011111111111133310P01
