111111101111100011000011113333
300013303301100033000011133333
300000000003000033000011133333
300111111303000000000011133033
300313113303000000000011133303
100313113333003000300333333333
310033133333033000000300333333
310000333313030030003330333303
310000033331330033333330333333
113000033331130333333000330333
313330013333310331133333113033
331333003313331133333331333033
333113000000030333330333133303
333331000000030033333333333303
111033133130000003333333133331
311133311133001000000001330331
111111111111111111111111111111
113331111313101333111113313331
111111113113311313111333111131
111111113131131131311111333311
