101000000000000000000000000P01
101000000000000000000000000P01
101111111111100000000000000P01
000000000000100000000000000P01
000000000000100000000000000P01
000000000000100000000000000P01
111111700000101111000011110P01
118111170033100000000000000P01
111111117003100000000000000P01
111111111000100000000000000P01
118411111003100000000000000P01
111111811033300006101111110P01
111111141011100061101441110P01
111111111011100611111111110P01
141181111111111111111100010P01
111111111111111111100000010P01
141111814111111111100000010P01
111111111111111111100000010P01
111111111111111411100000010P01
111114111111811111100000010P01
