1000000010100000000000000P0001
1000000010100000000000000P0001
1000000010100000000000000P0001
1111111110100000000000000P0001
1000000000100000000000000P0001
1011111111100001111100000P0001
10100000000000000P0000000P0001
10100000000000000P0000000P0001
10100000000000000P0000000P0001
10100000111110000P0000000P0001
1010000000P000000P0000000P0001
1010000000P000000P000001111101
1010000000P000000P000000000001
1010000000P000000P000000000001
1010000000P000000P000000000001
1010000000P000000P000000000001
1010000000P000000P000000000001
1010000000P0000111110000000001
1010000000P0000000000000000001
1010000000P0000000000000000001
