101110000011111111111100010P01
101110000000000000000000010P01
100110000000000000000000010P01
100111170000000000000000010P01
100001117000000000000000010P01
100001111000000000330000000P01
100000011110000000000000000P01
100000000000000000000033311111
100000000000000000000000011111
100000000000000000000000011111
101100000000000000330000011111
111100000000000000000000011111
111111000033330000000011111111
111111000033330000000011111111
100011333333333333000011111111
000001113333333333331111111111
117001001333333333331111111111
111700001113333311333111111111
111170001111333311333311111111
111111101111100011000011111111
