1010000000P0000000000000000001
1010000000P0000000000000000001
1010000000P0000000000000000001
1010000000P0000000000000111111
1010000000P0000000000000000P01
1010000000P0000000000000000P01
1010000000P0000000000000000P01
1010000000P0000000000000000P01
1010000000P0000000000000000P01
1010000000P0000000000000000P01
101000001111100000001111100P01
101000000000000000000000000P01
101000000000000000000000000P01
101000000000000000000000000P01
101000000000000000000000000P01
101000000000000000000000000P01
101000000000000000000000000P01
101000000000000000000000000P01
101000000000000000000000000P01
101000000000000000000000000P01
