111111111111111001111111111111
111111111110000000000111111111
001100000000000000000000000001
000000000000000110000000000001
000000000000000110000000000001
111100000000000110000000000001
111100000011111111111110000001
111100000000000000000000000001
111111000000000000000000000001
100000000000000000000000000001
100000011111110000000000000001
100000000000000000011111111111
100000000000000000100000000000
100000000000000010000000000000
100000000000000100000111111111
100000000000000000000000000001
000000000000000000000000000001
000000000011111111111110000001
111111100000000000000000000001
111111111111111111111111110001
