11111ZZZZZZZZ11111111111111111
100000000000000000000000000001
100000000000000000000000000001
100000000000000000000000000001
110000000000000000000000000001
110000000000000000000000000001
110000000000000000000000000001
111111111100000000000000000001
100000000111111100000000000001
100000000000000111111000000001
100000000000000000000000000001
100000000000000000000000000001
100000110000000000000000000000
100000110000000000000000000000
100000111111111110001111111111
100000111111111110001111000000
100000000000000011111000000000
100000000000000000000000000000
111111111111111111111111111111
111111111111111111111111111111
