111111111111111111111111110001
100000000000000000000000000001
100000000000000000000000000001
100000000000000000000000000111
000000000000000000000000000111
000000000000000000000000111111
111111111111111111111111111111
100000000000000000000000000001
100000000000000000000000000001
100000000000000000000000000000
100000000000000000000000000000
100000000000000000000000000000
100001111111111111111111111111
100000000000000000000000000001
100000000000000000000000000001
100000000000000000000000000000
000000000000000000000000000000
000000000000000000000000000000
000000000000000000000000000000
11111ZZZZZZZZ11111111111111111
