111111111111111111111111111111
100000000000000000000000000001
100000000000000000000000000001
100000000000000000000000000001
100000000000000000000000000001
100000000000000000000000000001
100000000000000000000000000001
100000000000000000000000000001
100000000000000000000000000001
000000000000000000000000000001
000000000000000000000000000001
100000000000000000000000000001
100000000000000000000000000000
100000000000000000000000000000
000000000000000000000000000000
000000000000000000000000000000
111111111100000000000011111111
111111111111000000001111111111
111111111111100000011111111111
111111111111111001111111111111
