111111111111111111111111111111
100000000000000000000000000001
100000000000000000000000000001
000000000000000000000000000001
000000000000000000000000000111
000000000000000000000000000001
100000000000000001111110000001
111100000111000000000000000001
100000000001100000000000000001
100011100000000000000000000001
100000000000011000000000000001
100000000000011100000000000001
100000001100001100000000000001
100000000000000111110000000001
100000000000000000000000000111
100000000000000000000000111111
100000011111110111111100000001
000110000000000000000000000001
000110000000000000000000000001
111111111111111111111111111111
