111111111111111111100000111111
100111111111111111100000000001
100000000000000000000000000001
100111111111111111111100000001
100000000011000000000000000001
100000000011000000000000000001
100000000000000000000000011111
100111111111000000000000000001
100000000011000000000000000001
100000000011100000000000000001
111111110011100000111000000001
100000000011100000111000000001
G00000000000000000111000000001
000000000000000000000001111111
111111111111100000000001000001
100000000011100111111111000001
100000000011100000000000000001
100000000000111111111111110001
100000000000000000000000000001
111100000111111111111111111111
