111111111111111111111111111111
100000000000000000000000000001
100000000000000000000000000001
100000000000000000000000000001
100000000000000000000000000001
100000000000000000000000000001
100000000000000000000000000001
100000000000000000000000000001
100000000000000000000000000001
100000000000000000000111110001
100000000000000000000000000001
100000000000000000001111110001
000000000000000000000000000181
000000000000000000111111111111
0000000000111110001ZZZZZZZZ111
000000000000000000ZZZZZZZZZ111
1111114141111111111ZZZZZZZZ111
1111111111111111111ZZZZZZZZ111
1111111111111111111ZZZZZZZZ111
111111111111111111100000111111
