111111111111111111111111111111
100000000000000000000000000001
100000000000000000000000000001
100000000000000000000000000001
100000000000000000000000000001
100000000000000000000000000001
100000000000000000000000000001
100000000000000000000000000001
100000000000000000000000000001
100000000000000000000000000001
100000000000000000000000000001
100000000000000000000000000001
000000000000000000000000000111
000000000000000000000000000111
000000000000000000111111111111
000000000000000000ZZZZZZZZZ111
1111111111111111111ZZZZZZZZ111
1111111111111111111ZZZZZZZZ111
1111111111111111111ZZZZZZZZ111
111111111111111111100000111111
