111100000111111111111111111111
100100000000000000000000000001
100100000000000000000000000001
100111100000000000000000000001
100000000000000000000000000001
100000011000000000000000000001
100000000001100000000000000001
100000000000110000000000000001
100000000000000000000000000001
000000000000000000110000000001
000000000000000001100000000001
000000000000000000000000000001
000000000000110000000000000001
111000000000110000000000000001
111111111111111111110000000001
100000000000000000000000001111
000000000000000000000000001111
000000000000000000000011111111
000000000000000000000011111111
111111111110000000111111111111
