111111111111000000011111111111
100000000000000000010000000001
100000000000000000010000000001
100000000000000001110000000001
100000000000000000000000000001
100000000000000000000000000001
111000000000001111111000000001
111000000000000000000000000001
111111111100000000000000000001
100000000000000000000000000001
100000000000000000000000000001
100000000000001111111000000001
000000000000000011100000000001
000000000000000011100000011111
111111111000000011100000000001
000000000000000011100000000001
000000000000111111111110000001
000000000000000000000000000001
111111111111111111111111111111
111111111111111111111111111111
