333333333333333333333333P33333
333333333333333333333333P33333
333333333333333333333333P33333
333333333333333333333333P33333
333333330000333333333333P33333
333333330000333333333333P30003
333333330330333333333333P30003
333333330330000000000000P30003
333333330330000000000000P00003
333000000330000000000000P33003
333011111111111111170000P30003
333033333333311000017000P30003
333033333333311000011700P30033
333033333330000000033100P10003
333033333330000000033100P10003
333000000000000033333111110R03
333111111111111133300011110113
333333333333333113000011110113
333333333333333311000000000113
333333333333333331111111111133
