111111111111111111111111111111
100000000010000001000000000001
100000000010000000000000000001
100000000010000000000000000001
111111100010000000000000000001
100000000000000000000000000001
100000000000000000000000000001
100000000000000000000000000001
100000000000000000000011111111
100000000000000000000010001111
100000000000000000000010000001
100000000000000000000010000000
100000000000000000000010000000
100000000000000000000010000000
100000000000000000000010001111
111111101111111111111111111111
100000000000000000000000000000
100000000000000000000000000000
100000000000000000000000000000
111111111111111111111111111111
