111111111111111111111111111111
100000000000000000000000000001
100000000000000000000000000001
Z00000000000000000000000000001
Z00000000000000000000000000001
110000000000000000000000000001
110000000000000011100000000001
110000000000000010000000000001
110000000000000000000000000001
100000000000111000000000000001
100000000000000000000000000001
100000011110000000000000000001
100000000000000000011111111111
111000000000000000000000000001
111000000000111100000000000001
111000000000000000000000000001
111000111000000000000000000001
1110000000000000A000000000000Z
11111111111111111000000000000Z
111111111111111111111111111111
