111111111111111111111111111111
100000000000000111111110000000
100000000000000000000000000000
100000000000000000000000000000
100000000000000000000000011111
100000000000000000000000100000
100000000000000000000001000000
100000000000000000000100000000
100000000000000000001000000000
111111111000000011110000111111
100000111111000001100000000001
100000000000000000000000000001
100000000000001111111100000001
100000000000000000000000000001
100000000000000000000000011111
100000000000000000000000011000
100000000000000000000001111000
100000000000000000000000001111
100001111000000111110000001111
111111111111111111111111111111
