111111111111111111111111111111
100000000000000000000000000001
100000000000000000000000000001
10000000000000000000000000000Z
10000000000000000000000000000Z
10000000000000000000000000000Z
100000000000000000000061111111
100000000000000000000611111111
10000000000A000000006111111111
100000000011100000011111111111
000000000011100000001111111111
000000000011111110000111111111
000000000000000000000000111111
111111100000000000000000000001
111110000000000000000000000001
000000000111111110000000000001
000000000000000000000000000000
000000000000000000001110000000
000000000000000000001110000000
111111111111111111111111111111
