11100P000001111111111111111111
11100P000001111111111Z11111111
11100P000001111111111ZZZZZZZZZ
11100P000001111111111Z11111111
11100P000001111111111Z11111111
11100P000001111111111Z11111111
11100P000001111111111Z11111111
11100P000001111111111Z11111111
11100P000000111111110001111111
11100P000000111111110E01111111
11100P000000111111110Z01111111
11100P000000111111111Z11111111
11100P000000111111111Z11111111
11100P000000111111111Z11111111
11100P000000111111111Z11111111
11100P000000011111111Z11111111
11100P000000011111111Z11111111
11100P000000011111111Z11111111
11100P000000011111111Z11111111
11100P000000011111111Z11111111
