11100P000000011111111Z11111111
11100P00000001ZZZZZZZZZZZZZZZZ
11100P00000001ZZZZZZZZZZZZZZZZ
11100P00000001ZZZZZZZZZZZZZZZZ
11100P000000010111111111111111
11100P000000000000000000001111
11100P000000000000000000001111
11100P000000000000000000001111
11100P000000111110000000001111
11100P000000000000000000001111
11100P000000000000000000001111
11100P000000000000000000000000
11100P000000000000000000000000
11100P000000000000000000003333
11100P000000000033000000003333
11100P000000000000000000003333
11100P003333333000033333333333
11100P003333330000033333333333
11100P003333330000033333333333
11100P003333330000333333333333
