11100P003333330000033333333333
11100P003333330000033333333333
11100P003333330000033333333333
11100P003333333000033333333333
11100P003333330000033333333333
11100P003333330000333333333333
11100P003333330000033333333333
11100P003333333000033333333333
11100P000000000000030033333333
11100P000000000000330033333333
11100P000000000000000033000333
11100P000000000000000033000333
111111111111111110000033030333
111111111113111110000003330033
111131131311113110000000030033
111133333331331333110000033033
111133333333333313110000033033
111133333333333333310000033000
111133333333333333331111111111
111133333333333333333333331111
