111111111111111000000000P01111
111111111111111000000000P01111
111111111111111000000000P01111
11100P000011111000000000P01111
11100P000011111330000000P01111
11100P000011133333300061111111
11100P000011110000000611111111
11100P000011100000006111111111
11100P000011100000061111111111
11100P000000000000611111111111
11100P000000000006111111111111
11100P000000000061111111111111
11100P001110000611111111111111
11100P000010006111111111111111
11100P000011111111111111111111
11100P000011111111111111111111
11100P000011111111111111111111
11100P000001111111111111111111
11100P000001111111111111111111
11100P000001111111111111111111
