111333133111111000000000001111
311333113111111000000000001111
331311113111311000000000001111
311311113311311000000000001111
111331111311111000000000001111
111313311111133000000000001111
111133333311110000001111111111
131333311311100000000000P00011
133333313311100000000000P00011
333331311111100000000000P00011
133333133311130000000000P00000
133331331311331000000000P00000
113311331331131000000000P00000
133113331331131000000000P01111
113333331111133000000000P01111
111311133111333000000000P01111
311331133111300000000000P01111
311333113111100000000000P01111
333333311111111000000000P01111
133333331331111000000000P01111
