110118118111118111181111111141
180111111144111111111141181111
ZZ0181411811181141188111118111
811110000000000000000000000011
111110000000000000000000000014
118110000000000000000000000011
141110000000000000000000000011
111180000000000000000000000018
111110000000000000011000000011
811410000000000000011000000041
111110000000000000001100000011
111110000000000000001100000018
141480000000000000000110000011
141110000000000000000110000081
111810000000D00000000011000000
111110000000100000000011000000
141110000000100000000000000000
811144111811118111111181118111
111114111111141111811111411411
411881181141111811111411111118
