333330000000000000000000P33333
333330000000000000000000P33333
333330000000000000000000P33333
333330000011000000000000P33333
333330000000000000000000P33333
333330000000000000000100P33333
333330000000011000000000P33333
333330000000000000000000P33333
333330000000000000000000P33333
333330000011000000000000P33333
333330000000000000000000P33333
333330000000010000100000P33333
333330011000000000000000P33333
333330000000000000000000P33333
333331511511151511511151133333
333335151111551115151511533333
333331115111111551111111533333
333335511151511111111511533333
333331511511111515151115133333
333335115155151115111511133333
