33333333333333333ZZZZZZZP33333
333333333333333330000000P33333
333330000000000000000000P33333
3333300R0000000000000000P33333
333330010000000000000000P33333
333330000000000100000000P33333
333330000000000000000000P33333
333330000000010000000000P33333
333330000000000000000000P33333
333330000001000000000000P33333
333330000000000000000000P33333
333330000000000000000000P33333
333330100000010000000000P33333
333330000000000000000000P33333
333330000000000000000000P33333
333330000011000000000000P33333
333330000000000000000000P33333
333330000000000000001000P33333
333330000000000000000000P33333
333330011000000000000000P33333
