111111111111111111111111111111
ZZ0000000000000000000000000000
ZZ0000000000000000000000011111
ZZ0000000000001111111111110011
111111111111111000000000000011
110000000000000000000000000011
110000000000000000000000000011
110000000000000000000000000011
110000000000000000000000000011
110000000000000000000000000011
110000000000000000000000000011
000000000000000000000000000011
000000000000000000000000001111
333330000000000000000000011111
333330000000000000000000011111
333333333333333000000000000000
333333333333333000000000000000
333333333333333333333333333333
333333333333333333333333333333
333333333333333333333333333333
