110111118111111111181111111141
180111111114111111111141181111
ZZ0181411111181141118111111111
811110000000000000000000000011
111110000000000000000000000014
111110000000000000000000000011
141110000000000000000000000011
111180000000000000000000000018
111110000000000000011000000011
811410000000000000011000000041
111110000000000000001100000011
111110000000000000001100000011
111110000000000000000110000011
111110000000000000000110000081
111810000000D00000000011000000
111110000000100000000011000000
141110000000100000000000000000
111114111811111141111111118111
111111111111141111111111411111
411181181111111811111411111118
