330000000000000000000000033333
330000000000000000000000033333
330000000000000000000000033333
330000000000000000000000033333
330000000000000000000000033333
300000000000000000000000033133
330000000000000000000000000333
330033333300333333333330000333
131133333300330003333330000333
133330033300330003333331111333
333300033333333303033313333333
333300033333333333333133333333
333311333330003301331310P33333
313333333030003313111330P33333
3333333330003333Z0ZZ0ZZ0P33333
333300333000333301133313P33333
333300000330000000000000P33333
000000003310000000000000P33333
33131003133333313ZZZZZZZP33333
31331333133333133ZZZZZZZP33333
