111111111111111111111111111111
100000000000000000000000000001
100000000000000000000000000001
10000000000000000000000000000Z
10000000000000000000000000000Z
10000000000000000000000000000Z
100000000000000000000061111111
100000000000000000000611811141
100000000000000000006111111111
100000000011133300031141118111
000000000013133330001111181111
000000000081111330000114111111
000000033331110000000000111811
111700000000100000000000000001
111170000000100000000000000001
114117000111111111000000000001
1411117000000G0000000000000000
111811170000000000001110000000
111111417000000000001140000000
111111111111131111111111111111
