141111111111101118811181111111
111118111111101111111111111811
111111111411101141114111111111
111111111111101111111111111111
114111411110000011111111041111
181111111110000011111111111141
11111118000000001100G000011111
114111110000000014000000011111
111111110000000000000000014181
111114110014111114111100011111
411111110011111111111100011111
1118111100111111111811000ZZZZZ
111181110011814114111111111111
110000000011111111111111111111
110000000011111111111411111111
11Z111111111141114111111411141
11Z141111411111181111111111111
81Z111111111111111111881111111
11Z118141811411811411111184111
11Z111111181111111111111111181
