111111111111111111111111111111
100000000000000000000000000001
100000000000000060000000000001
100000000000000610000000000001
107000000000006110000000000001
101700000000061100000000000001
100170000000611000000000000001
100017000006110000000000000001
100000000061100000000000000001
10000000061100P000000000000001
10000000000000P000000000000001
10000000000000P000000000000001
10001111110000P000000000000001
11000000000000P000000000000611
11111111111100P000000000006111
G0000000000000P000002222211111
00001170000000P000001ZZZZZZ111
11111117000000P00000ZZZZZZZ111
11111111700000P00000ZZZZZZZ111
111111111111111111111ZZZZZZ111

